//MAP CONVERTED BY dmm2tgm.py THIS HEADER COMMENT PREVENTS RECONVERSION, DO NOT REMOVE
"a" = (
/obj/effect/spawner/structure/window,
/turf/open/floor/plating,
/area/shuttle/mining)
"b" = (
/turf/closed/wall,
/area/shuttle/mining)
"d" = (
/obj/machinery/power/shuttle_engine/heater{
	dir = 1
	},
/obj/structure/window/reinforced/spawner/directional/east,
/obj/structure/window/reinforced/spawner/directional/west,
/obj/structure/window/reinforced/spawner/directional/south,
/turf/open/floor/plating,
/area/shuttle/mining)
"f" = (
/turf/open/floor/plating,
/area/shuttle/mining)
"h" = (
/obj/docking_port/mobile{
	dir = 8;
	shuttle_id = "mining";
	name = "mining shuttle";
	port_direction = 4
	},
/turf/open/floor/plating,
/area/shuttle/mining)
"j" = (
/obj/machinery/computer/shuttle/mining{
	dir = 1
	},
/turf/open/floor/plating,
/area/shuttle/mining)
"l" = (
/obj/machinery/power/shuttle_engine/propulsion/burst{
	dir = 1
	},
/turf/open/floor/plating,
/area/shuttle/mining)

(1,1,1) = {"
b
b
a
a
a
b
b
"}
(2,1,1) = {"
b
f
f
f
f
f
b
"}
(3,1,1) = {"
l
d
f
f
f
j
a
"}
(4,1,1) = {"
b
f
f
f
f
f
b
"}
(5,1,1) = {"
b
b
b
h
b
b
b
"}
