//MAP CONVERTED BY dmm2tgm.py THIS HEADER COMMENT PREVENTS RECONVERSION, DO NOT REMOVE
"a" = (
/obj/effect/spawner/structure/window,
/turf/open/floor/plating,
/area/shuttle/mining)
"d" = (
/obj/machinery/computer/shuttle/mining,
/turf/open/floor/plating,
/area/shuttle/mining)
"f" = (
/turf/open/floor/plating,
/area/shuttle/mining)
"h" = (
/obj/docking_port/mobile{
	dir = 8;
	shuttle_id = "mining";
	name = "mining shuttle";
	port_direction = 4
	},
/obj/structure/door_assembly/door_assembly_shuttle,
/turf/open/floor/plating,
/area/shuttle/mining)
"j" = (
/obj/structure/window/reinforced/spawner/directional/east,
/obj/structure/window/reinforced/spawner/directional/west,
/obj/machinery/power/shuttle_engine/heater,
/obj/structure/window/reinforced/spawner/directional/north,
/turf/open/floor/plating,
/area/shuttle/mining)
"k" = (
/turf/closed/wall/mineral/titanium,
/area/shuttle/mining)
"T" = (
/obj/machinery/power/shuttle_engine/propulsion/burst,
/turf/open/floor/plating,
/area/shuttle/mining)

(1,1,1) = {"
k
k
a
a
a
k
k
"}
(2,1,1) = {"
k
f
f
f
f
f
k
"}
(3,1,1) = {"
a
d
f
f
f
j
T
"}
(4,1,1) = {"
k
f
f
f
f
f
k
"}
(5,1,1) = {"
k
k
k
h
k
k
k
"}
